###########E#########
#         #         #
# ### ### # ####### #
#   # #   #       # #
# ### # ########### #
# #   #             #
### ############### #
#   #         #     #
# ########### # #####
#           #       #
# ######### #########
# #       #     #   #
# ### # ####### # ###
#   # #       #   # #
### # ##### # ##### #
#   # #     #   #   #
# ##### ####### ### #
#       #   #   #   #
######### ### ### # #
#                 # #
###########R#########
